.env.example	smtp_pass
.github/copilot-instructions.md	smtp_pass
.github/workflows/auto-pr-handler.yml	generic_secret
.github/workflows/bandit.yml	generic_secret
.github/workflows/ci.yml	generic_secret
.github/workflows/main.yml	generic_secret
.github/workflows/summary.yml	generic_secret
.github/workflows/super-linter.yml	generic_secret
README.md	smtp_pass
docker-compose.yml	smtp_pass
docs/guides/QUICK_START.md	openai
docs/notes/IMPROVEMENT_AUDIT.md	generic_secret
docs/notes/QUICK_START.md	openai
docs/overview/IMAGE_GENERATION_QUICKSTART.md	generic_secret
docs/overview/IMAGE_GENERATION_RESTORATION.md	openai
docs/overview/INFRASTRUCTURE.md	generic_secret
docs/policy/SECURITY.md	generic_secret
docs/security/SECURITY_AUDIT_EXECUTIVE_SUMMARY.md	openai
docs/security/SECURITY_AUDIT_REPORT.md	openai
docs/security/SECURITY_COMPLIANCE_CHECKLIST.md	openai
docs/web/DEPLOYMENT.md	generic_secret